<map>
00000000000000000000000000000000000000000000000000000000000000000000000000000000000000000000000000000000000000000000000000000000000000000000000000000000000000000000000000000000000000000000
00000000000000000000000000000000000000000000000000000000111111000000000000000111111100000000100000100001111111100001000010000000000000000000000000000000000000000000000000000000000000000000
00000000000000000000000000000000000000020000000000000000100000000010000010000100000100000000101010100001000000100000101000000000000000000000000000000000000000000000000000000000000000000000
00000000000000000000000000000000000000000000000000000000111111000010000010000111111100000000100100100001111111100000010000000000000000000000000000000000000000000000000000000000000000000000
00000000000000000000000000000000000000000000000000000000000001000010000010000100000000000000100000100001000000100000101000000000000000000000000000000000000000000000000000000000000000000000
00000000000000000000000000000000000000000101010101000000111111000011111110000100000000000000100000100001000000100001000100000000000000000000000000000000000000000000000000000000000000000000
00000000000000000000000000000000000000000100000001000000000000000000000000000000000000000000000000000000000000000000000000000000000000000000000000000000000000000001000000000000000000000000
01010101010101010101010101010101010112010100000001010101010101010101010112000001010101010101010101011201000101010101010101010101011200000001010101010101010101120101111111111111111100000000
00000000000000000000000000000000000000000000000000000000000000000000000001000001000000000000000000000001040100000000000000000000000100000001000000000000000000000000000000000000000000000000
00000000000000000000000000000000000000000000000000000000000000000000000001000001000000000000000000000001010100000000000000000000000104040401000000000000000000000000000000000000000000000000
00000000000000000000000000000000000000000000000000000000000000000000000001010101000000000000000000000000000000000000000000000000000101010101000000000000000000000000000000000000000000000000
00000000000000000000000000000000000000000000000000000000000000000000000000000000000000000000000000000000000000000000000000000000000000000000000000000000000000000000000000000000000000000000
00000000000000000000000000000000000000000000000000000000000000000000000000000000000000000000000000000000000000000000000000000000000000000000000000000000000000000000000000000000000000000000
00000000000000000000000000000000000000000000000000000000000000000000000000000000000000000000000000000000000000000000000000000000000000000000000000000000000000000000000000000000000000000000
</map>
<tip>
Touch anywhere on the screen to jump. I guess you probably figured that out by now...also hi max!
</tip>
